# ################## # # # #
#                    # # # #
# ################## # # # #
# #                  # # # #
# # #### # ### ####### # # #
# ###    #B##       ## # # #
# #################### # # #
#                  ### # # #
###### ####### ## #### # # #
##         ### ## #### # # #
########## ###            ##
A           ################